03 03 03 03 00 00 00 00 00 00 00 00 00 00 00 00 00 00 00 00 08 00 11 08 10 00 00 08 00 00
03 03 03 03 00 04 05 00 00 00 01 08 00 02 00 17 00 08 10 11 16 03 03 16 00 08 10 16 00 00
03 03 03 03 00 12 13 01 00 00 00 16 00 00 08 00 08 16 08 03 03 03 03 03 03 16 11 00 08 00
03 03 03 03 03 07 04 05 00 02 00 00 00 00 16 10 16 00 16 03 03 03 03 03 03 03 10 08 16 00
00 04 05 00 03 03 12 13 01 00 00 11 01 00 08 10 00 03 03 03 03 03 03 03 03 03 08 16 00 02
00 12 13 00 00 00 03 03 00 08 00 00 00 10 16 00 08 03 03 03 03 03 03 03 03 03 16 00 08 10
01 00 00 10 00 00 00 03 03 16 08 00 11 00 01 00 16 03 03 03 03 03 03 03 03 03 03 11 16 08
00 00 00 00 01 00 00 00 03 00 16 00 00 00 00 11 03 03 03 03 03 03 03 03 03 03 03 08 00 16
00 00 00 00 00 00 10 00 03 03 03 03 03 03 03 03 03 03 03 03 03 03 03 03 03 08 00 16 00 00
00 00 02 00 02 00 00 00 00 03 03 00 00 00 00 00 08 07 08 03 08 03 03 00 11 16 00 17 08 00
00 00 00 00 00 00 00 08 00 03 00 00 01 00 02 00 16 00 16 00 16 08 00 08 00 01 00 00 16 00
00 00 01 00 00 00 00 16 03 03 00 00 00 00 00 00 00 00 00 01 08 16 00 16 00 17 08 00 00 00
00 00 00 00 00 00 00 00 03 00 08 00 00 00 00 00 01 18 19 20 16 00 00 00 01 00 16 00 00 01
00 00 10 02 00 00 01 00 03 00 16 00 02 00 00 00 00 26 27 28 00 00 04 05 00 00 00 00 02 00
00 00 00 00 00 08 00 00 03 00 00 00 00 01 00 08 07 34 35 36 00 00 12 13 09 00 01 11 00 00
00 00 00 00 00 16 00 00 03 00 00 00 00 00 00 16 00 00 03 00 00 01 00 00 00 00 11 00 00 00
10 00 00 00 00 00 00 00 03 03 03 03 03 03 00 00 00 00 03 00 00 17 00 00 44 45 46 47 00 00
00 40 41 42 43 00 00 03 03 00 00 00 00 03 03 03 00 03 03 00 00 00 00 24 52 53 54 55 00 00
00 48 49 50 51 00 11 03 00 00 00 00 00 00 00 03 03 03 00 00 02 00 11 32 60 61 62 63 00 00
00 56 57 58 59 11 00 03 00 08 00 00 00 02 00 00 03 03 03 00 00 00 00 00 07 03 00 00 00 11
11 11 03 03 03 07 00 03 00 16 00 00 00 00 00 00 00 08 03 03 03 03 03 03 03 03 00 00 00 00
00 00 00 03 03 03 03 03 00 00 00 00 00 00 00 00 00 16 00 00 00 00 00 03 03 00 00 02 00 00
00 00 00 00 03 00 00 00 00 00 02 00 00 00 00 00 00 00 00 00 00 00 00 00 00 00 00 00 00 00
